  1 1 1 1 1 1 1 1 1 1 1 1 1 1 1 1 1 1 1 1 1 1 1 1
  1 42 9 9 9 9 9 9 9 9 9 9 9 9 9 9 9 9 9 9 9 9 9 1 
  1 9 9 9 9 9 9 9 9 9 9 9 9 9 9 9 9 9 9 9 9 9 9 1 
  1 9 9 9 9 9 9 9 9 9 9 9 9 9 9 9 9 9 9 9 9 9 9 1 
  1 9 9 9 9 9 1 1 1 1 1 9 9 9 9 1 9 1 9 1 9 9 9 1 
  1 9 9 9 9 9 1 9 9 9 1 9 9 9 9 9 9 9 9 9 9 9 9 1 
  1 9 9 9 9 9 1 9 6 9 1 9 9 9 9 1 9 9 9 1 9 9 9 1 
  1 9 9 9 9 9 1 9 9 9 1 9 9 9 9 9 9 9 9 9 9 9 9 1 
  1 9 9 9 9 9 1 1 9 1 1 9 9 9 9 1 9 1 9 1 9 9 9 1 
  1 9 9 9 9 9 9 9 9 9 9 9 9 9 9 9 9 9 9 9 9 9 9 1 
  1 9 9 9 9 9 9 9 9 9 9 9 9 9 9 9 9 9 9 9 9 9 9 1 
  1 9 9 9 9 9 9 9 9 9 9 9 5 9 9 9 9 9 9 9 9 9 9 1 
  1 9 9 9 9 9 9 9 9 9 9 9 9 9 9 9 9 9 9 9 9 9 9 1 
  1 9 9 9 9 9 9 9 9 9 9 9 9 9 9 9 9 9 9 9 9 9 9 1 
  1 9 9 9 9 9 9 9 9 9 9 9 9 9 9 9 9 9 9 9 9 9 9 1 
  1 9 9 9 9 9 9 9 9 9 9 9 9 9 9 9 9 9 9 9 9 9 9 1 
  1 1 1 1 1 1 1 1 1 9 9 9 9 9 9 9 9 9 9 9 9 9 9 1 
  1 1 9 1 9 9 9 9 1 9 9 9 9 9 9 9 9 9 9 9 9 9 9 1 
  1 1 9 9 9 9 6 9 1 9 9 9 9 9 9 9 9 9 9 9 9 9 9 1 
  1 1 9 1 9 9 9 9 1 9 9 9 9 9 9 9 9 9 9 9 9 9 9 1 
  1 1 9 1 1 1 1 1 1 9 9 9 9 9 9 9 9 9 9 9 9 9 9 1 
  1 1 9 9 9 9 9 9 9 9 9 9 9 9 9 9 9 9 9 9 9 9 9 1 
  1 1 1 1 1 1 1 1 1 9 9 9 9 9 9 9 9 9 9 9 9 9 9 1 
  1 1 1 1 1 1 1 1 1 1 1 1 1 1 1 1 1 1 1 1 1 1 1 1
